111111111111111111
100CEP011111111111
101110111111111111
100000111111111111
111111111111111111
111111111111111111
111111111111111111
111111111111111111
111111111111111111
111111111111111111
