11111111
100CEP01
10111011
10000011
11111111
