111111111111111111111111111111111
10E0000000C000000000C000000000001
101110111000001000111010010111C01
101C00101000001000101011010100001
101110101000001000101010110101001
100C101010000010001010101101C1001
101110111011101110111010010111001
1000000000000P0000000000C00000001
111111111111111111111111111111111
